D..#######
##.......#
##.#######
##.#.#####
##....####
##.#.#####
##.#...###
##.#.#####
##.#######
##.......#
########A#